rs_adap1	AACATTATTAGATCGGAAGAGCACACGTCTGAACTC
rs_adap2	AAAGTGTTGAGATCGGAAGAGCACACGTCTGAACTC
rs_adap3	AAGAATTATAGATCGGAAGAGCACACGTCTGAACTC
rs_adap4	AATATGGACAGATCGGAAGAGCACACGTCTGAACTC
rs_adap5	AATCACTTGAGATCGGAAGAGCACACGTCTGAACTC
rs_adap6	ACCAAGTCGAGATCGGAAGAGCACACGTCTGAACTC
rs_adap7	ACAACTCGCAGATCGGAAGAGCACACGTCTGAACTC
rs_adap8	ACCCGTCTTAGATCGGAAGAGCACACGTCTGAACTC
rs_adap9	ACCCTACAGAGATCGGAAGAGCACACGTCTGAACTC
rs_adap10	ACCCTCGGCAGATCGGAAGAGCACACGTCTGAACTC
rs_adap11	ACCGGTACCAGATCGGAAGAGCACACGTCTGAACTC
rs_adap12	ACGGAGGGCAGATCGGAAGAGCACACGTCTGAACTC
rs_adap13	ACTCGGTACAGATCGGAAGAGCACACGTCTGAACTC
rs_adap14	ACGGCACTTAGATCGGAAGAGCACACGTCTGAACTC
rs_adap15	ACTCTAACTAGATCGGAAGAGCACACGTCTGAACTC
rs_adap16	ACTGGATCGAGATCGGAAGAGCACACGTCTGAACTC
rs_adap17	AGCAGCCACAGATCGGAAGAGCACACGTCTGAACTC
rs_adap18	AGAGATTGTAGATCGGAAGAGCACACGTCTGAACTC
rs_adap19	AGAGCCATCAGATCGGAAGAGCACACGTCTGAACTC
rs_adap20	AGTAACTGCAGATCGGAAGAGCACACGTCTGAACTC
rs_adap21	AGGCCCAAGAGATCGGAAGAGCACACGTCTGAACTC
rs_adap22	AGTCTGGCGAGATCGGAAGAGCACACGTCTGAACTC
rs_adap23	AGGTCCTCTAGATCGGAAGAGCACACGTCTGAACTC
rs_adap24	ATCATCGTGAGATCGGAAGAGCACACGTCTGAACTC
rs_adap25	ATACAACATAGATCGGAAGAGCACACGTCTGAACTC
rs_adap26	ATCCCGCGGAGATCGGAAGAGCACACGTCTGAACTC
rs_adapGG	ACCCCCCCCAGATCGGAAGAGCACACGTCTGAACTC
rs_adapRT	GGAAGAGCACACGTCTGAACTC
rs_adapRT2	AGCACACGTCTGAACTCCAGTCACT
